00000000000000000000000000000000000000
00000000000000000000000000000000000000
00000000000000000000000000000000000000
00000000000000000000000000000000000000
00000000000000000000000000000000000000
00000000000000000000000000000000000000
00000000000000000000000000000000000000
00000000000000000000000000000000000000
00000000000000000000000000000000000000
00000000000000000000000000000000000000
B000000000000000B00000000000000000000B
B000000000000000B00000000000000000000B
B000000P0000000BBB0000000000000000000B
B000000GG0000000B00000000000000000000B
Bt0000GDDG00000tB00000000000000000000B
DGGGGGDDDDGGGGGGGGGGGGGGGGGGGGGGGGGGGG