00000000000000000
00000000000000000
00000000000000000
00000000000000000
00000000000000000
00000000000000000
00000000000000000
00000000000000000
00000000000000000
00000000000000000
B000000000000000B
B000000000000000B
B000000000000000B
B000000GG0000000B
B0P000GDDG000000B
DGGGGGDDDDGGGGGGD